1111111111111111
1000100000001001
1110111101010101
1000100011010111
1010001000101001
1010010011000001
1111111111111111
